NAME: rangerofthewest_small_water_arrival_vault
TAGS: arrival
MONS: random; 
KFEAT: 
MAP
xxxWWWxxx
xxWWTWWxx
xWW...WWx
WW.....WW
WT..{..TW
WW.....WW
xWW...WWx
xxWWTWWxx
xxxWWWxxx
ENDMAP